{
  "name": "map_001",
  "width": 600,
  "height": 600,
  "bounce_top": true,
  "bounce_left": true,
  "bounce_right": true,
  "bounce_bottom": false,
  "balls": {
    "normal": {
      "radius": 8,
      "colour": ["ORANGE", "SEAGREEN_1"],
      "max_x_speed": 15,
      "max_y_speed": 15,
      "hp": 1000
    },
    "large": {
      "radius": 16,
      "colour": ["RED", "SPRINGGREEN_1"],
      "max_x_speed": 15,
      "max_y_speed": 15,
      "hp": 2500
    }
  },
  "legend": {
    "empty": {
      "": {
        "colour": "BLACK"
      }
    },
    "wall": {
      "W": {
        "colour": "GRAY_27"
      }
    },
    "brick": {
      "1": {
        "hp": 1,
        "colour": "GREEN"
      },
      "2": {
        "hp": 2,
        "colour": "MELON"
      }
    },
    "paddle": {
      "P": {
        "colour": "WHITE"
      }
    }
  },
  "map":[
    ["", "", "", "", "", "", "", "", "", "", "", "", "", "", "", "", "", "", "", "", "", "", "", "", "", "", "", "", "", "", "", "", "", "", "", "", "", "", "", ""],
    ["", "", "", "", "", "", "", "", "", "", "", "", "", "", "", "", "", "", "", "", "", "", "", "", "", "", "", "", "", "", "", "", "", "", "", "", "", "", "", ""],
    ["", "", "", "", "", "", "", "", "", "", "W", "W", "W", "W", "W", "W", "W", "W", "W", "W", "W", "W", "W", "W", "W", "W", "W", "W", "W", "W", "", "", "", "", "", "", "", "", "", ""],
    ["", "", "", "", "", "", "", "", "", "", "W", "1", "1", "1", "1", "1", "1", "1", "1", "1", "1", "1", "1", "1", "1", "1", "1", "1", "1", "W", "", "", "", "", "", "", "", "", "", ""],
    ["", "", "", "", "", "", "", "", "", "", "W", "1", "1", "1", "1", "1", "1", "1", "1", "1", "1", "1", "1", "1", "1", "1", "1", "1", "1", "W", "", "", "", "", "", "", "", "", "", ""],
    ["", "", "", "", "", "", "", "", "", "", "W", "1", "1", "1", "1", "1", "1", "1", "1", "1", "1", "1", "1", "1", "1", "1", "1", "1", "1", "W", "", "", "", "", "", "", "", "", "", ""],
    ["", "", "", "", "", "", "", "", "", "", "W", "1", "1", "1", "1", "1", "1", "1", "1", "1", "1", "1", "1", "1", "1", "1", "1", "1", "1", "W", "", "", "", "", "", "", "", "", "", ""],
    ["", "", "", "", "", "", "", "", "", "", "W", "1", "1", "1", "1", "1", "1", "1", "1", "1", "1", "1", "1", "1", "1", "1", "1", "1", "1", "W", "", "", "", "", "", "", "", "", "", ""],
    ["", "", "", "", "", "", "", "", "", "", "W", "1", "1", "2", "2", "2", "1", "1", "1", "1", "1", "1", "1", "1", "1", "1", "1", "1", "1", "W", "", "", "", "", "", "", "", "", "", ""],
    ["", "", "", "", "", "", "", "", "", "", "W", "1", "1", "2", "2", "2", "1", "1", "1", "1", "1", "1", "1", "1", "1", "1", "1", "1", "1", "W", "", "", "", "", "", "", "", "", "", ""],
    ["", "", "", "", "", "", "", "", "", "", "W", "1", "1", "1", "1", "1", "1", "1", "1", "1", "1", "1", "1", "1", "1", "1", "1", "1", "1", "W", "", "", "", "", "", "", "", "", "", ""],
    ["", "", "", "", "", "", "", "", "", "", "W", "1", "1", "1", "1", "1", "1", "1", "1", "1", "1", "1", "1", "1", "1", "1", "1", "1", "1", "W", "", "", "", "", "", "", "", "", "", ""],
    ["", "", "", "", "", "", "", "", "", "", "W", "1", "1", "1", "1", "1", "1", "1", "1", "1", "1", "1", "1", "1", "1", "1", "1", "1", "1", "W", "", "", "", "", "", "", "", "", "", ""],
    ["", "", "", "", "", "", "", "", "", "", "W", "1", "1", "1", "1", "1", "1", "1", "1", "1", "1", "1", "1", "1", "1", "1", "1", "1", "1", "W", "", "", "", "", "", "", "", "", "", ""],
    ["", "", "", "", "", "", "", "", "", "", "W", "1", "1", "1", "1", "1", "1", "1", "1", "1", "1", "1", "1", "1", "1", "1", "1", "1", "1", "W", "", "", "", "", "", "", "", "", "", ""],
    ["", "", "", "", "", "", "", "", "", "", "W", "1", "1", "1", "1", "1", "1", "1", "1", "1", "1", "1", "1", "1", "1", "1", "1", "1", "1", "W", "", "", "", "", "", "", "", "", "", ""],
    ["", "", "", "", "", "", "", "", "", "", "W", "1", "1", "1", "1", "1", "1", "1", "1", "1", "1", "1", "1", "1", "1", "1", "1", "1", "1", "W", "", "", "", "", "", "", "", "", "", ""],
    ["", "", "", "", "", "", "", "", "", "", "W", "1", "1", "1", "1", "1", "1", "1", "1", "1", "1", "1", "1", "1", "1", "1", "1", "1", "1", "W", "", "", "", "", "", "", "", "", "", ""],
    ["", "", "", "", "", "", "", "", "", "", "W", "1", "1", "1", "1", "1", "1", "1", "1", "1", "1", "1", "1", "1", "1", "1", "1", "1", "1", "W", "", "", "", "", "", "", "", "", "", ""],
    ["", "", "", "", "", "", "", "", "", "", "W", "1", "1", "1", "1", "1", "1", "1", "1", "1", "1", "1", "1", "1", "1", "1", "1", "1", "1", "W", "", "", "", "", "", "", "", "", "", ""],
    ["", "", "", "", "", "", "", "", "", "", "W", "1", "1", "1", "1", "1", "1", "1", "1", "1", "1", "1", "1", "1", "1", "1", "1", "1", "1", "W", "", "", "", "", "", "", "", "", "", ""],
    ["", "", "", "", "", "", "", "", "", "", "W", "1", "1", "1", "1", "1", "1", "1", "1", "1", "1", "1", "1", "1", "1", "1", "1", "1", "1", "W", "", "", "", "", "", "", "", "", "", ""],
    ["", "", "", "", "", "", "", "", "", "", "W", "1", "1", "1", "1", "1", "1", "1", "1", "1", "1", "1", "1", "1", "1", "1", "1", "1", "1", "W", "", "", "", "", "", "", "", "", "", ""],
    ["", "", "", "", "", "", "", "", "", "", "W", "1", "1", "1", "1", "1", "1", "1", "1", "1", "1", "1", "1", "1", "1", "1", "1", "1", "1", "W", "", "", "", "", "", "", "", "", "", ""],
    ["", "", "", "", "", "", "", "", "", "", "W", "1", "1", "1", "1", "1", "1", "1", "1", "1", "1", "1", "1", "1", "1", "1", "1", "1", "1", "W", "", "", "", "", "", "", "", "", "", ""],
    ["", "", "", "", "", "", "", "", "", "", "W", "1", "1", "1", "1", "1", "1", "1", "1", "1", "1", "1", "1", "1", "1", "1", "1", "1", "1", "W", "", "", "", "", "", "", "", "", "", ""],
    ["", "", "", "", "", "", "", "", "", "", "W", "1", "1", "1", "1", "1", "1", "1", "1", "1", "1", "1", "1", "1", "1", "1", "1", "1", "1", "W", "", "", "", "", "", "", "", "", "", ""],
    ["", "", "", "", "", "", "", "", "", "", "W", "1", "1", "1", "1", "1", "1", "1", "1", "1", "1", "1", "1", "1", "1", "1", "1", "1", "1", "W", "", "", "", "", "", "", "", "", "", ""],
    ["", "", "", "", "", "", "", "", "", "", "W", "1", "1", "1", "1", "1", "1", "1", "1", "1", "1", "1", "1", "1", "1", "1", "1", "1", "1", "W", "", "", "", "", "", "", "", "", "", ""],
    ["", "", "", "", "", "", "", "", "", "", "W", "1", "1", "1", "1", "1", "1", "1", "1", "1", "1", "1", "1", "1", "1", "1", "1", "1", "1", "W", "", "", "", "", "", "", "", "", "", ""],
    ["", "", "", "", "", "", "", "", "", "", "W", "W", "W", "W", "W", "W", "W", "W", "W", "W", "W", "W", "W", "W", "W", "", "", "", "", "W", "", "", "", "", "", "", "", "", "", ""],
    ["", "", "", "", "", "", "", "", "", "", "", "", "", "", "", "", "", "", "", "", "", "", "", "", "", "", "", "", "", "", "", "", "", "", "", "", "", "", "", ""],
    ["", "", "", "", "", "", "", "", "", "", "", "", "", "", "", "", "", "", "", "", "", "", "", "", "", "", "", "", "", "", "", "", "", "", "", "", "", "", "", ""],
    ["", "", "", "", "", "", "", "", "", "", "", "", "", "", "", "", "", "", "", "", "", "", "", "", "", "", "", "", "", "", "", "", "", "", "", "", "", "", "", ""],
    ["", "", "", "", "", "", "", "", "", "", "", "", "", "", "", "", "", "", "", "", "", "", "", "", "", "", "", "", "", "", "", "", "", "", "", "", "", "", "", ""],
    ["", "", "", "", "", "", "", "", "", "", "", "", "", "", "", "", "", "", "", "", "", "", "", "", "", "", "", "", "", "", "", "", "", "", "", "", "", "", "", ""],
    ["", "", "", "", "", "", "", "", "", "", "", "", "", "", "", "", "", "", "", "", "", "", "", "", "", "", "", "", "", "", "", "", "", "", "", "", "", "", "", ""],
    ["", "", "", "", "", "", "", "", "", "", "", "", "", "", "", "", "", "", "", "", "", "", "", "", "", "", "", "", "", "", "", "", "", "", "", "", "", "", "", ""],
    ["", "", "", "", "", "", "", "", "", "", "", "", "", "", "", "", "", "", "", "", "", "", "", "", "", "", "", "", "", "", "", "", "", "", "", "", "", "", "", ""],
    ["", "", "", "", "", "", "", "", "", "", "", "", "", "", "", "", "", "", "", "", "", "", "", "", "", "", "", "", "", "", "", "", "", "", "", "", "", "", "", ""]
  ]
}